-,-,-,-,-,-,-,-,-,-,-,-,-,-,-,-,-,-,-,-,-,-,-,-,-,-,-,-,-,-,-,-,-,-,-,-,-
|,x, , , , , , , , , , , , , , , , , , , , , , , , , , , , , , , , , , ,|
|, , , , , , , , , , , , , , , , , , , , , , , , , , , , , , , , , , , ,|
|, , , , , , , , , , , , , , , , , , , , , , , , , , , , , , , , , , , ,|
|, , , , , , , , , , , , ,#,-,-,-,-,-,-,-,-,#, , , , , , , , , , , , , ,|
|, , , , , , , , , , , , ,|, , , , , , , , ,|, , , , , , , , , , , , , ,|
|, , , , , , , , , , , , ,|, , , , , , , , ,|, , , , , , , , , , , , , ,|
|, , , , , , , , , , , , ,#,-,-,-,-,-,-,-,-,#, , , , , , , , , , , , , ,|
|, , , , , , , , , , , , , , , , , , , , , , , , , , , , , , , , , , , ,|
|, , , , , , , , , , , , , , , , , , , , , , , , , , , , , , , , , , , ,|
|, , , , , ,#,-,-,-,-,#, , , , , , , , , , , , ,#,-,-,-,-,#, , , , , , ,|
|, , , , , ,|, , , , , , , , , , , , , , , , , , , , , , ,|, , , , , , ,|
|, , , , , ,|, , , , , , , , , , , , , , , , , , , , , , ,|, , , , , , ,|
|, , , , , ,|, , , , , , , , , , , , , , , , , , , , , , ,|, , , , , , ,|
|, , , , , ,|, , , , , , , , , , , , , , , , , , , , , , ,|, , , , , , ,|
|, , , , , ,#, , , , , , , ,#,-,-,-,-,-,-,#, , , , , , , ,#, , , , , , ,|
|, , , , , , , , , , , , , ,|, , , , , , ,|, , , , , , , , , , , , , , ,|
|, , , , , , , , , , , , , ,|, , , , , , ,|, , , , , , , , , , , , , , ,|
|, , , , , , , , , , , , , ,|, , , , , , ,|, , , , , , , , , , , , , , ,|
|, , , , , , , , , , , , , ,|, , , , , , ,|, , , , , , , , , , , , , , ,|
|, , , , , , , , , , , , , ,|, , , , , , ,|, , , , , , , , , , , , , , ,|
|, , , , , ,#, , , , , , , ,#,-,-,-,-,-,-,#, , , , , , , ,#, , , , , , ,|
|, , , , , ,|, , , , , , , , , , , , , , , , , , , , , , ,|, , , , , , ,|
|, , , , , ,|, , , , , , , , , , , , , , , , , , , , , , ,|, , , , , , ,|
|, , , , , ,|, , , , , , , , , , , , , , , , , , , , , , ,|, , , , , , ,|
|, , , , , ,|, , , , , , , , , , , , , , , , , , , , , , ,|, , , , , , ,|
|, , , , , ,#,-,-,-,-,#, , , , , , , , , , , , ,#,-,-,-,-,#, , , , , , ,|
|, , , , , , , , , , , , , , , , , , , , , , , , , , , , , , , , , , , ,|
|, , , , , , , , , , , , , , , , , , , , , , , , , , , , , , , , , , , ,|
|, , , , , , , , , , , , ,#,-,-,-,-,-,-,-,-,#, , , , , , , , , , , , , ,|
|, , , , , , , , , , , , ,|, , , , , , , , ,|, , , , , , , , , , , , , ,|
|, , , , , , , , , , , , ,|, , , , , , , , ,|, , , , , , , , , , , , , ,|
|, , , , , , , , , , , , ,#,-,-,-,-,-,-,-,-,#, , , , , , , , , , , , , ,|
|, , , , , , , , , , , , , , , , , , , , , , , , , , , , , , , , , , , ,|
|, , , , , , , , , , , , , , , , , , , , , , , , , , , , , , , , , , , ,|
|, , , , , , , , , , , , , , , , , , , , , , , , , , , , , , , , , , ,+,|
-,-,-,-,-,-,-,-,-,-,-,-,-,-,-,-,-,-,-,-,-,-,-,-,-,-,-,-,-,-,-,-,-,-,-,-,-